44444444444444444444444444444444444444444444444444
44444444444444444444444444444444444444444444444444
44444444000000004440000000000000444444440000004444
44444000000000000000000000000000000444000000004444
44440000004444400000000044444000000000000000004444
44440000044400000000000000444440000000000000004444
44440000000000001111100000044000000000000000004444
44440000000000001333100000000000000000000000044444
44440000000000001333100000000000000000000000444444
44444400000000001131100000000000000000000000444444
44444400000000000000000000000000000000000000004444
44444440000000000000000000000000000000000000004444
44440000000000000000000000000000000000000000004444
44440000000000000000002222200000000000000000004444
44440000000000000000022222220000000000000000004444
44440000000000000000022222220000000000000000004444
44440000000000000000000222222222000000000000004444
44440000000000000000000000222200000000000000004444
44440000000000000000000000000000000000000000044444
44444000000000000000000000000000000000000000444444
44444000000000000000000000000000000000000000444444
44444400000000000000000000000000000000000004444444
44444400000000000000000000000000000000000000004444
44440000000000000000000000000000000000000000004444
44440000000000000000000000000000000000000000004444
44440000000000000000000000000000000000000000004444
44440000000000000000000000000000000000000000004444
44440000000000000000000000000000000000000000004444
44440000000000000000000000000000000000000000004444
44440000000000000000000000000000000000000000004444
44440000000000000000055555555555555555500000004444
44440000000000000000000005555555555550000000004444
44440000000000000000000555555555500000000000004444
44440000000000000000000000000550000000000000004444
44440000000000000000000000000000000000000000004444
44440000000000000000000000000000000000000000004444
44440000000000000000000000000000000000000000004444
44440000000000000000000000000000000000000000004444
44440000000000000000000000000000000000000000004444
44440000000000000000000000000000000000000000004444
44440000000000000044400000000000000000000000004444
44440000000000044444444400000000000000000000004444
44440000000004444444440000000000000000000000004444
44440000000000004444000000000000000000000000004444
44440000000000000000000000000000000000000000004444
44440000000000000000000000000000000000000000004444
44444444400000000000000000000000000000000000444444
44444444444444444444400000000000000000004444444444
44444444444444444444444444444444444444444444444444
44444444444444444444444444444444444444444444444444
